18 18 18 18 18 18 18 18 18 18 18 18 18 18 18 18 18 18 18 18 18 18 18 18 18 18 18 18 18 18 18 18 18 18 18 18 18 18 18 18
18 18 18 18 18 18 18 18 18 18 18 18 18 18 18 18 18 18 18 18 18 18 18 18 18 18 18 18 18 18 18 18 18 18 18 18 18 18 18 18
18 18 18 18 18 18 18 18 18 18 18 18 18 18 18 18 18 18 18 18 18 18 18 18 18 18 18 18 18 18 18 18 18 18 18 18 18 18 18 18
18 18 18 18 18 18 19 20 19 19 19 19 19 19 19 19 19 19 19 19 20 19 19 19 19 19 19 19 19 19 19 19 19 19 19 18 18 18 18 18
19 21 22 23 24 18 19 20 19 19 19 19 19 19 19 19 19 19 19 19 20 19 19 19 19 19 19 19 19 19 19 19 19 19 19 18 18 18 18 18
19 25 26 27 28 18 19 20 19 19 19 20 19 19 19 19 19 19 20 20 20 20 20 20 19 19 19 19 19 19 19 19 19 19 19 18 18 18 18 18
19 29 30 31 32 18 19 20 19 19 19 19 19 19 19 19 19 19 19 19 20 19 19 19 19 19 19 20 19 19 19 19 19 19 19 18 18 18 18 18
18 18 19 19 18 18 19 20 19 19 19 20 19 19 19 19 19 19 19 19 20 19 19 19 19 19 19 20 19 19 19 19 19 19 19 18 18 18 18 18
18 18 19 19 18 18 19 20 19 19 19 20 19 19 19 19 19 19 19 19 20 19 19 19 19 19 19 20 19 19 19 19 19 19 19 18 18 18 18 18
18 18 19 19 19 19 19 20 19 19 19 20 19 19 19 19 19 19 19 19 20 19 19 19 19 19 19 20 19 19 19 20 19 19 19 18 18 18 18 18
18 18 19 19 19 19 19 19 19 19 19 20 19 19 19 19 19 19 19 19 20 19 19 19 19 19 19 20 19 19 19 20 19 19 19 18 18 18 18 18
18 18 18 19 19 19 19 19 19 19 19 20 20 20 20 20 20 20 19 19 20 19 19 19 19 19 19 20 19 19 19 20 19 19 19 18 18 18 18 18
18 18 18 19 19 19 19 19 20 20 20 20 19 19 19 19 19 20 19 19 20 19 19 19 19 19 19 20 19 19 19 20 19 19 19 18 18 18 18 18
18 18 18 18 19 19 19 19 20 19 19 20 19 19 19 20 19 20 19 19 20 19 19 19 19 19 19 20 19 19 19 20 19 19 19 18 18 18 18 18
18 18 18 18 18 19 19 19 20 19 19 20 19 19 19 20 19 20 19 19 20 19 19 19 19 19 19 20 20 20 20 20 19 19 19 18 18 18 18 18
18 18 18 18 18 19 19 19 20 19 19 20 19 19 19 20 19 20 19 19 20 19 19 19 19 19 19 20 20 20 20 20 19 19 19 18 18 18 18 18
18 18 18 18 18 19 19 19 20 19 19 20 19 19 19 20 19 20 19 19 20 19 19 19 19 19 19 20 19 19 19 20 19 19 19 18 18 18 18 18
18 18 18 18 18 19 19 19 20 19 19 20 19 19 19 20 19 19 19 19 20 19 19 19 19 19 19 20 19 19 19 20 19 19 19 18 18 18 18 18
18 18 18 18 18 19 19 19 20 19 19 20 19 19 19 20 19 19 19 19 20 19 19 19 19 19 19 20 19 19 19 20 19 19 19 18 18 18 18 18
18 18 18 18 18 19 19 19 19 19 19 20 19 19 19 20 19 19 19 19 20 19 19 19 19 19 19 20 19 19 19 20 19 19 19 18 18 18 18 18
18 18 18 18 18 19 19 19 19 19 19 20 19 19 19 20 19 19 19 19 20 19 19 19 19 19 19 20 19 19 19 20 19 19 19 18 18 18 18 18
18 18 18 18 18 19 19 19 20 20 20 20 19 19 19 20 19 19 19 19 20 19 19 19 20 20 20 20 19 19 19 20 20 20 20 18 18 18 18 18
18 18 18 18 18 19 19 19 20 19 19 19 19 19 19 20 19 19 19 19 20 19 19 19 20 20 20 20 19 19 19 20 20 20 20 18 18 18 18 18
18 18 18 18 18 19 19 19 20 19 19 19 19 19 19 20 19 19 19 19 20 19 19 19 19 19 19 20 19 19 19 20 19 19 19 18 18 18 18 18
18 18 18 18 18 19 19 19 20 19 19 19 19 19 19 20 19 19 19 19 20 19 19 19 19 19 19 20 19 19 19 20 19 19 19 18 18 18 18 18
18 18 18 18 18 19 19 19 20 19 19 19 19 19 19 20 20 20 20 20 20 19 19 19 19 19 19 20 19 19 19 20 19 19 19 18 18 18 18 18
18 18 18 18 18 19 19 19 20 19 19 19 19 19 19 20 19 19 19 19 19 19 19 19 19 19 19 20 19 19 19 20 19 19 19 18 18 18 18 18
18 18 18 18 18 19 19 19 20 20 19 19 19 20 20 20 20 20 19 19 19 19 19 19 19 19 19 20 19 19 19 20 19 19 19 18 18 18 18 18
18 18 18 18 18 19 19 19 19 19 19 19 19 19 19 19 19 19 19 19 19 19 19 19 19 19 19 19 19 19 19 20 19 19 19 18 18 18 18 18
18 18 18 18 18 19 19 19 19 19 19 19 19 19 19 19 19 19 19 19 19 19 20 20 20 19 19 19 19 19 19 20 19 19 19 18 18 18 18 18
18 18 18 18 18 20 20 20 20 20 20 19 19 19 19 19 19 19 19 19 19 19 19 19 20 19 19 19 19 19 19 20 19 19 19 18 18 18 18 18
18 18 18 18 18 20 20 20 20 20 20 19 19 19 19 19 19 19 19 19 19 19 19 19 20 19 19 19 19 19 19 20 19 19 19 18 18 18 18 18
18 18 18 18 18 19 19 19 19 19 19 19 19 19 19 19 19 19 19 19 20 20 20 20 20 20 20 20 19 19 19 19 19 19 19 18 18 18 18 18
18 18 18 18 18 19 19 19 19 19 19 19 19 19 19 19 19 19 19 19 19 19 20 19 19 19 19 20 19 19 19 19 19 19 19 18 18 18 18 18
18 18 18 18 18 19 19 19 19 19 19 19 19 20 20 20 20 20 20 20 20 20 20 20 19 19 19 20 19 19 19 19 19 19 19 18 18 18 18 18
18 18 18 18 18 19 19 19 19 19 19 19 19 19 19 19 20 20 20 19 19 19 19 19 19 19 19 19 19 19 19 19 19 19 19 18 18 18 18 18
18 18 18 18 18 19 19 19 19 19 19 19 19 19 19 19 20 20 20 19 19 19 19 19 19 19 19 19 19 19 19 19 19 19 19 18 18 18 18 18
18 18 18 18 18 18 18 18 18 18 18 18 18 18 18 18 18 18 18 18 18 18 18 18 18 18 18 18 18 18 18 18 18 18 18 18 18 18 18 18
18 18 18 18 18 18 18 18 18 18 18 18 18 18 18 18 18 18 18 18 18 18 18 18 18 18 18 18 18 18 18 18 18 18 18 18 18 18 18 18
18 18 18 18 18 18 18 18 18 18 18 18 18 18 18 18 18 18 18 18 18 18 18 18 18 18 18 18 18 18 18 18 18 18 18 18 18 18 18 18


